###############
#     o       #
############  #
#      x      #
# ########### #
#      #o     #
#  o   #      #
###############
