#########################################
#       #o              #               #
#############           #               #
#                       #      o        #
#              o        #               #
#       #########       #               #
#               #       #               #
#               #                       #
#               #                       #
# x                                     #
#########################################