#######################################
#  #####     #     #     #       #    #
#    #     #   #   #     #     # o #  #
#    #     #####    #   #      #####  #
#  x #     #   #     # #       #   #  #
#  ##      #   #      # o      #   #  #
#######################################