#####
# o #
#   #
# x #
#####
