###################################
#x                  #             #
#       # #######  ######         #
#       #              o#o        #
###################################