#########################
#      #       #        #
#                       #
#                       #
#                       #
#       #########       #
#       #       #       #
#  o    #   x           #
#########################