######
#    #
# x  #
#  ###
######
