######
#  x #
# x  #
#    #
######
