######
#    ###
# x    #
#  o   #
#    ###
######
